15, NULL
23, NULL
26, NULL
79, NULL
80, NULL
81, NULL
82, NULL
83, NULL
84, NULL
85, NULL
86, NULL
87, NULL
88, NULL
89, NULL
90, NULL
91, NULL
92, NULL
93, NULL
94, NULL
95, NULL
96, NULL
97, NULL
98, NULL
99, NULL
100, NULL
101, NULL
102, NULL
103, NULL
104, NULL
0, Single, 95, 0, 48, 127, 127, 127, 126, 64
8, PSG2, 0, 0, 60, 110, 127, 60, 120, 64
10, PSG1, 3, 0, 60, 126, 100, 50, 118, 64
19, Single, 85, 0, 60, 127, 122, 122, 120, 64
20, Single, 3, 1, 60, 127, 120, 127, 120, 64
22, Single, 55, 0, 60, 116, 90, 110, 120, 64
25, Single, 15, 0, 57, 127, 10, 120, 116, 64
28, Single, 8, 1, 60, 127, 127, 127, 125, 64
31, PSG1, 3, 0, 60, 126, 100, 40, 127, 64
33, Single, 105, 0, 28, 127, 60, 1, 116, 64
34, Single, 89, 0, 28, 127, 60, 1, 116, 64
35, Single, 51, 0, 38, 127, 127, 127, 118, 64
36, Single, 101, 0, 31, 127, 127, 127, 112, 64
37, Single, 100, 0, 36, 127, 127, 127, 114, 64
38, Single, 121, 0, 36, 127, 125, 127, 118, 64
39, Single, 122, 0, 36, 127, 127, 127, 112, 64
41, Single, 72, 0, 67, 127, 110, 127, 115, 64
42, PSG1, 3, 0, 60, 127, 50, 0, 125, 64
43, Single, 64, 0, 60, 99, 99, 99, 110, 64
44, Single, 45, 0, 60, 99, 10, 0, 80, 64
49, Single, 75, 0, 61, 127, 120, 127, 118, 64
50, Single, 76, 0, 59, 127, 120, 127, 110, 64
52, PSG1, 3, 0, 60, 127, 70, 0, 110, 64
53, Single, 94, 0, 60, 127, 70, 0, 120, 64
54, Single, 17, 0, 60, 125, 127, 127, 127, 64
55, Single, 74, 0, 48, 127, 120, 127, 112, 64
62, PSG1, 1, 0, 60, 124, 100, 80, 110, 64
63, PSG1, 0, 0, 60, 124, 100, 80, 110, 64
64, Single, 123, 0, 36, 127, 125, 127, 114, 64
65, Single, 10, 0, 60, 127, 117, 126, 118, 64
67, PSG1, 3, 0, 60, 124, 100, 80, 110, 64
68, Single, 71, 0, 60, 127, 100, 90, 114, 64
69, PSG2, 0, 0, 60, 125, 100, 0, 120, 64
70, PSG1, 1, 0, 60, 90, 127, 80, 110, 64
71, Single, 120, 0, 60, 127, 100, 100, 114, 64
72, PSG1, 3, 0, 60, 124, 100, 80, 120, 64
74, Single, 157, 0, 84, 120, 90, 70, 122, 64
75, Single, 6, 1, 36, 127, 120, 127, 120, 64
76, Single, 7, 1, 48, 127, 120, 127, 120, 64
77, Single, 5, 1, 60, 127, 120, 127, 120, 64
1, Drums, 28, 88
	1, 102, 0, 28, 127, 0, 110, 125, 64
	1, 54, 0, 29, 127, 127, 120, 125, 64
	1, 103, 0, 30, 127, 0, 110, 125, 64
	1, 95, 0, 31, 3, 127, 127, 126, 64
	1, 11, 0, 32, 127, 127, 120, 125, 64
	1, 12, 0, 33, 127, 127, 120, 125, 64
	1, 0, 0, 34, 127, 116, 0, 124, 64
	1, 14, 0, 35, 127, 127, 127, 127, 64
	1, 13, 0, 36, 127, 127, 127, 120, 64
	1, 98, 0, 36, 127, 116, 0, 126, 58
	1, 73, 0, 38, 127, 127, 127, 127, 64
	1, 53, 0, 39, 127, 127, 120, 125, 70
	1, 93, 0, 40, 127, 114, 90, 127, 64
	1, 127, 0, 53, 127, 127, 127, 125, 30
	1, 28, 0, 42, 127, 127, 120, 125, 80
	1, 127, 0, 50, 127, 127, 127, 125, 40
	1, 86, 0, 44, 127, 127, 122, 126, 80
	1, 127, 0, 45, 127, 127, 127, 125, 50
	1, 77, 0, 46, 127, 102, 0, 127, 80
	1, 127, 0, 41, 127, 127, 127, 125, 100
	1, 127, 0, 36, 127, 127, 127, 125, 107
	1, 30, 0, 52, 127, 90, 0, 114, 64
	1, 127, 0, 36, 127, 127, 127, 126, 117
	1, 97, 0, 53, 127, 70, 0, 114, 30
	1, 21, 0, 53, 127, 70, 0, 110, 20
	1, 96, 0, 53, 127, 70, 0, 106, 30
	1, 124, 0, 54, 127, 127, 127, 125, 58
	1, 104, 0, 55, 127, 70, 0, 110, 84
	1, 20, 0, 56, 127, 127, 127, 120, 110
	1, 30, 0, 57, 127, 70, 0, 114, 36
	1, 30, 0, 57, 127, 70, 0, 114, 102
	1, 97, 0, 59, 127, 70, 0, 114, 86
	1, 16, 0, 60, 127, 127, 127, 120, 90
	1, 16, 0, 64, 127, 127, 127, 120, 90
	1, 70, 0, 62, 127, 127, 127, 120, 20
	1, 60, 0, 63, 127, 127, 127, 120, 24
	1, 60, 0, 67, 127, 127, 127, 120, 26
	1, 9, 0, 65, 127, 127, 127, 120, 26
	1, 9, 0, 66, 127, 127, 127, 120, 101
	1, 18, 0, 67, 127, 100, 90, 120, 26
	1, 70, 0, 68, 127, 127, 127, 120, 100
	1, 60, 0, 69, 127, 127, 127, 120, 98
	1, 60, 0, 67, 127, 127, 127, 120, 102
	1, 61, 0, 71, 127, 127, 127, 126, 25
	1, 40, 0, 72, 127, 127, 127, 126, 112
	1, 40, 0, 76, 127, 127, 127, 126, 100
	1, 40, 0, 79, 127, 127, 127, 126, 34
	1, 40, 0, 83, 127, 127, 127, 126, 22
	1, 156, 0, 77, 127, 127, 127, 120, 34
	1, 156, 0, 81, 127, 127, 127, 120, 90
	1, 156, 0, 84, 127, 127, 127, 127, 20
	1, 156, 0, 79, 127, 127, 127, 127, 107
	1, 132, 0, 80, 127, 120, 0, 127, 44
	1, 132, 0, 81, 127, 80, 0, 118, 44
	1, 99, 0, 82, 127, 100, 84, 124, 90
	1, 62, 0, 83, 127, 127, 127, 110, 94
	1, 9, 0, 74, 127, 127, 127, 120, 26
	1, 9, 0, 91, 127, 127, 127, 120, 101
	1, 9, 0, 81, 127, 127, 127, 120, 101
	1, 19, 0, 87, 127, 127, 127, 120, 20
	1, 63, 0, 88, 127, 0, 110, 100, 20
6, Drums, 27, 87
	1, 95, 0, 27, 3, 127, 127, 126, 64
	1, 14, 0, 28, 127, 127, 127, 127, 64
	1, 13, 0, 29, 127, 127, 127, 120, 64
	1, 73, 0, 30, 127, 127, 127, 127, 64
	1, 53, 0, 31, 127, 127, 120, 125, 70
	1, 93, 0, 32, 127, 114, 90, 127, 64
	1, 12, 0, 33, 127, 127, 120, 125, 64
	1, 0, 0, 34, 127, 116, 0, 124, 58
	1, 11, 0, 35, 127, 127, 120, 125, 64
	1, 12, 0, 36, 127, 127, 120, 125, 64
	1, 98, 0, 37, 127, 0, 110, 126, 64
	1, 102, 0, 38, 127, 0, 110, 125, 64
	1, 54, 0, 39, 127, 127, 120, 125, 64
	1, 103, 0, 40, 127, 0, 110, 125, 64
	1, 128, 0, 53, 127, 127, 127, 125, 30
	1, 29, 0, 42, 127, 127, 120, 125, 82
	1, 128, 0, 50, 127, 127, 127, 125, 40
	1, 86, 0, 44, 127, 127, 120, 125, 82
	1, 128, 0, 45, 127, 127, 127, 125, 50
	1, 78, 0, 46, 125, 110, 0, 125, 82
	1, 128, 0, 41, 127, 127, 127, 125, 90
	1, 128, 0, 36, 127, 127, 127, 125, 100
	1, 30, 0, 52, 127, 90, 0, 114, 64
	1, 128, 0, 36, 127, 127, 127, 126, 110
	1, 97, 0, 53, 127, 70, 0, 114, 30
	1, 21, 0, 53, 127, 70, 0, 110, 20
	1, 96, 0, 53, 127, 70, 0, 106, 30
	1, 124, 0, 54, 127, 127, 127, 125, 58
	1, 104, 0, 57, 127, 70, 0, 110, 84
	1, 20, 0, 56, 127, 127, 127, 120, 110
	1, 30, 0, 57, 127, 70, 0, 114, 36
	1, 30, 0, 57, 127, 70, 0, 114, 102
	1, 97, 0, 59, 127, 70, 0, 114, 86
	1, 16, 0, 60, 127, 127, 127, 120, 90
	1, 16, 0, 64, 127, 127, 127, 120, 90
	1, 70, 0, 62, 127, 127, 127, 120, 20
	1, 60, 0, 63, 127, 127, 127, 120, 24
	1, 60, 0, 67, 127, 127, 127, 120, 26
	1, 9, 0, 65, 127, 127, 127, 120, 26
	1, 9, 0, 66, 127, 127, 127, 120, 101
	1, 18, 0, 67, 127, 100, 90, 120, 26
	1, 70, 0, 68, 127, 127, 127, 120, 100
	1, 60, 0, 69, 127, 127, 127, 120, 98
	1, 60, 0, 67, 127, 127, 127, 120, 102
	1, 61, 0, 71, 127, 127, 127, 126, 25
	1, 40, 0, 72, 127, 127, 127, 126, 112
	1, 40, 0, 76, 127, 127, 127, 126, 100
	1, 40, 0, 79, 127, 127, 127, 126, 34
	1, 40, 0, 83, 127, 127, 127, 126, 22
	1, 156, 0, 77, 127, 127, 127, 120, 34
	1, 156, 0, 81, 127, 127, 127, 120, 90
	1, 156, 0, 81, 127, 127, 127, 120, 90
	1, 156, 0, 81, 127, 127, 127, 120, 90
	1, 132, 0, 80, 127, 120, 0, 127, 44
	1, 132, 0, 81, 127, 80, 0, 118, 44
	1, 99, 0, 82, 127, 100, 84, 124, 90
	1, 62, 0, 83, 127, 127, 127, 110, 94
	1, 62, 0, 83, 127, 127, 127, 110, 94
	1, 62, 0, 83, 127, 127, 127, 110, 94
	1, 62, 0, 83, 127, 127, 127, 110, 94
	1, 19, 0, 87, 127, 127, 127, 120, 94
16, Drums, 36, 38
	1, 2, 1, 36, 127, 127, 127, 120, 64
	1, 2, 1, 36, 127, 127, 127, 120, 64
	1, 4, 1, 38, 127, 127, 127, 127, 64
21, Keysplit, 35, 47, 59, 127, 0, 0, 0, 0
	1, 1, 0, 36, 127, 127, 127, 118, 64
	1, 2, 0, 48, 127, 127, 127, 118, 64
	1, 3, 0, 60, 120, 120, 117, 118, 64
	1, 4, 0, 72, 118, 120, 110, 118, 64
32, Keysplit, 34, 47, 127, 0, 0, 0, 0, 0
	1, 154, 0, 31, 127, 60, 1, 118, 64
	1, 155, 0, 44, 127, 60, 1, 120, 64
	1, 153, 0, 50, 127, 60, 1, 120, 64
66, Keysplit, 34, 47, 127, 0, 0, 0, 0, 0
	1, 154, 0, 31, 127, 127, 127, 118, 64
	1, 155, 0, 44, 127, 127, 127, 120, 64
	1, 153, 0, 50, 127, 127, 127, 120, 64
24, Keysplit, 45, 57, 69, 127, 0, 0, 0, 0
	1, 5, 0, 40, 127, 30, 90, 116, 64
	1, 6, 0, 52, 127, 30, 90, 116, 64
	1, 7, 0, 64, 127, 30, 90, 116, 64
	1, 8, 0, 76, 127, 30, 90, 116, 64
105, Keysplit, 57, 127, 0, 0, 0, 0, 0, 0
	1, 0, 1, 48, 127, 100, 0, 116, 64
	1, 1, 1, 60, 127, 100, 0, 116, 64
7, Keysplit, 43, 57, 127, 0, 0, 0, 0, 0
	1, 22, 0, 36, 127, 75, 1, 126, 64
	1, 23, 0, 48, 127, 75, 1, 126, 64
	1, 24, 0, 60, 127, 75, 1, 126, 64
27, Keysplit, 47, 59, 127, 0, 0, 0, 0, 0
	1, 25, 0, 36, 127, 90, 0, 120, 64
	1, 26, 0, 48, 127, 90, 0, 120, 64
	1, 27, 0, 60, 127, 90, 0, 120, 64
29, Keysplit, 47, 60, 72, 79, 127, 0, 0, 0
	1, 37, 0, 40, 127, 30, 1, 126, 64
	1, 36, 0, 48, 127, 30, 1, 126, 64
	1, 38, 0, 64, 127, 30, 1, 126, 64
	1, 39, 0, 76, 127, 30, 1, 126, 64
	1, 35, 0, 83, 127, 30, 1, 126, 64
4, Keysplit, 54, 127, 0, 0, 0, 0, 0, 0
	1, 43, 0, 60, 127, 100, 0, 125, 64
	1, 44, 0, 72, 127, 100, 0, 125, 64
5, Keysplit, 55, 127, 0, 0, 0, 0, 0, 0
	1, 41, 0, 60, 127, 80, 0, 116, 64
	1, 42, 0, 72, 127, 80, 0, 116, 64
73, Keysplit, 72, 89, 127, 0, 0, 0, 0, 0
	1, 48, 0, 72, 127, 90, 100, 118, 64
	1, 49, 0, 84, 127, 90, 90, 118, 64
	1, 50, 0, 96, 127, 90, 67, 118, 64
60, Keysplit, 55, 127, 0, 0, 0, 0, 0, 0
	1, 46, 0, 48, 115, 117, 118, 116, 64
	1, 47, 0, 72, 127, 117, 127, 116, 64
9, Keysplit, 127, 0, 0, 0, 0, 0, 0, 0
	1, 52, 0, 96, 127, 90, 0, 116, 64
46, Keysplit, 71, 83, 95, 127, 0, 0, 0, 0
	1, 56, 0, 60, 127, 80, 1, 116, 64
	1, 57, 0, 72, 127, 90, 1, 116, 64
	1, 58, 0, 84, 127, 100, 1, 116, 64
	1, 59, 0, 96, 127, 110, 1, 118, 64
3, Keysplit, 30, 127, 0, 0, 0, 0, 0, 0
	1, 110, 0, 24, 127, 75, 1, 108, 64
	1, 111, 0, 36, 127, 75, 1, 110, 64
12, Keysplit, 71, 83, 127, 0, 0, 0, 0, 0
	1, 65, 0, 60, 127, 90, 0, 114, 64
	1, 66, 0, 72, 127, 90, 0, 114, 64
	1, 67, 0, 84, 127, 90, 0, 114, 64
51, Keysplit, 48, 127, 0, 0, 0, 0, 0, 0
	1, 68, 0, 48, 127, 70, 1, 115, 64
	1, 69, 0, 60, 127, 70, 1, 115, 64
61, Keysplit, 47, 60, 72, 127, 0, 0, 0, 0
	1, 31, 0, 36, 127, 90, 127, 120, 64
	1, 32, 0, 48, 127, 90, 127, 120, 64
	1, 33, 0, 60, 127, 90, 127, 120, 64
	1, 34, 0, 72, 127, 90, 127, 120, 64
17, Keysplit, 59, 77, 89, 127, 0, 0, 0, 0
	1, 79, 0, 48, 127, 127, 127, 116, 64
	1, 80, 0, 60, 127, 120, 120, 116, 64
	1, 81, 0, 72, 127, 127, 127, 116, 64
	1, 82, 0, 84, 127, 127, 127, 116, 64
18, Keysplit, 59, 127, 0, 0, 0, 0, 0, 0
	1, 83, 0, 60, 127, 127, 127, 116, 64
	1, 84, 0, 72, 127, 127, 127, 116, 64
45, Keysplit, 71, 127, 0, 0, 0, 0, 0, 0
	1, 87, 0, 67, 127, 110, 100, 118, 64
	1, 88, 0, 79, 127, 114, 100, 119, 64
30, Keysplit, 43, 50, 127, 0, 0, 0, 0, 0
	1, 91, 0, 40, 127, 60, 90, 126, 64
	1, 90, 0, 47, 127, 60, 90, 126, 64
	1, 92, 0, 52, 127, 60, 90, 126, 64
48, Keysplit, 43, 53, 69, 127, 0, 0, 0, 0
	1, 106, 0, 36, 127, 100, 120, 116, 64
	1, 107, 0, 48, 127, 105, 110, 116, 64
	1, 108, 0, 60, 122, 110, 100, 116, 64
	1, 109, 0, 72, 122, 115, 90, 116, 64
2, Keysplit, 43, 57, 64, 71, 76, 83, 88, 127
	1, 118, 0, 43, 127, 75, 1, 110, 64
	1, 112, 0, 48, 127, 75, 1, 110, 64
	1, 113, 0, 60, 127, 75, 1, 116, 64
	1, 119, 0, 67, 127, 80, 1, 116, 64
	1, 114, 0, 72, 127, 85, 1, 116, 64
	1, 117, 0, 77, 127, 90, 1, 116, 64
	1, 115, 0, 84, 127, 90, 1, 116, 64
	1, 116, 0, 96, 127, 90, 1, 116, 64
47, Keysplit, 48, 127, 0, 0, 0, 0, 0, 0
	1, 126, 0, 41, 127, 80, 1, 116, 64
	1, 125, 0, 46, 127, 80, 1, 116, 64
57, Keysplit, 52, 62, 127, 0, 0, 0, 0, 0
	1, 133, 0, 48, 127, 100, 100, 116, 64
	1, 134, 0, 60, 127, 100, 100, 116, 64
	1, 135, 0, 72, 127, 100, 100, 116, 64
56, Keysplit, 64, 84, 127, 0, 0, 0, 0, 0
	1, 130, 0, 61, 127, 100, 80, 116, 64
	1, 131, 0, 73, 127, 100, 80, 116, 64
	1, 129, 0, 83, 127, 110, 80, 116, 64
59, Keysplit, 64, 84, 127, 0, 0, 0, 0, 0
	1, 130, 0, 61, 127, 100, 110, 116, 64
	1, 131, 0, 73, 127, 100, 110, 116, 64
	1, 129, 0, 83, 127, 110, 110, 116, 64
58, Keysplit, 31, 127, 0, 0, 0, 0, 0, 0
	1, 140, 0, 36, 127, 127, 126, 118, 64
	1, 141, 0, 48, 127, 127, 126, 118, 64
14, Keysplit, 66, 78, 90, 127, 0, 0, 0, 0
	1, 136, 0, 48, 127, 80, 0, 110, 64
	1, 137, 0, 60, 127, 80, 0, 110, 64
	1, 138, 0, 72, 127, 80, 0, 110, 64
	1, 139, 0, 84, 127, 80, 0, 110, 64
11, Keysplit, 47, 59, 71, 83, 95, 127, 0, 0
	1, 142, 0, 36, 127, 90, 0, 118, 64
	1, 143, 0, 48, 127, 90, 0, 118, 64
	1, 144, 0, 60, 127, 90, 0, 116, 64
	1, 145, 0, 72, 127, 90, 0, 116, 64
	1, 146, 0, 84, 127, 90, 0, 116, 64
	1, 147, 0, 96, 127, 90, 0, 116, 64
40, Keysplit, 47, 69, 88, 127, 0, 0, 0, 0
	1, 148, 0, 36, 120, 100, 127, 116, 64
	1, 149, 0, 60, 120, 90, 127, 116, 64
	1, 150, 0, 72, 116, 90, 86, 116, 64
	1, 151, 0, 84, 110, 90, 70, 116, 64
78, Keysplit, 127, 0, 0, 0, 0, 0, 0, 0
	1, 152, 0, 84, 127, 90, 70, 118, 64
13, Keysplit, 48, 65, 76, 88, 127, 0, 0, 0
	1, 158, 0, 48, 127, 80, 40, 118, 64
	1, 159, 0, 60, 127, 80, 40, 118, 64
	1, 160, 0, 72, 127, 80, 60, 118, 64
	1, 161, 0, 84, 127, 80, 60, 118, 64
	1, 162, 0, 96, 127, 90, 40, 118, 64
Unused, 0, 0
